Calotriton_arnoldi	CR	decreasing
Calotriton_asper	NT	decreasing
Chioglossa_lusitanica	VU	decreasing
Cynops_ensicauda	EN	decreasing
Cynops_pyrrhogaster	LC	stable
Echinotriton_andersoni	EN	decreasing
Echinotriton_chinhaiensis	CR	decreasing
Euproctus_montanus	LC	stable
Euproctus_platycephalus	EN	decreasing
Ichthyosaura_alpestris	LC	decreasing
Laotriton_laoensis	EN	decreasing
Lissotriton_boscai	LC	stable
Lissotriton_helveticus	LC	stable
Lissotriton_italicus	LC	decreasing
Lissotriton_montandoni	LC	decreasing
Lissotriton_vulgaris	LC	stable
Lyciasalamandra_antalyana	EN	decreasing
Lyciasalamandra_atifi	EN	stable
Lyciasalamandra_billae	CR	decreasing
Lyciasalamandra_fazilae	EN	stable
Lyciasalamandra_flavimembris	EN	decreasing
Lyciasalamandra_helverseni	VU	stable
Lyciasalamandra_luschani	VU	stable
Mertensiella_caucasica	VU	decreasing
Neurergus_crocatus	VU	decreasing
Neurergus_kaiseri	CR	decreasing
Neurergus_microspilotus	CR	decreasing
Neurergus_strauchii	VU	decreasing
Notophthalmus_meridionalis	EN	decreasing
Notophthalmus_perstriatus	NT	decreasing
Notophthalmus_viridescens	LC	stable
Ommatotriton_ophryticus	NT	decreasing
Ommatotriton_vittatus	LC	decreasing
Pachytriton_brevipes	LC	decreasing
Pachytriton_labiatus	LC	decreasing
Paramesotriton_caudopunctatus	NT	decreasing
Paramesotriton_chinensis	LC	decreasing
Paramesotriton_deloustali	VU	decreasing
Paramesotriton_fuzhongensis	VU	decreasing
Paramesotriton_hongkongensis	NT	decreasing
Pleurodeles_nebulosus	VU	decreasing
Pleurodeles_poireti	EN	decreasing
Pleurodeles_waltl	NT	decreasing
Salamandra_algira	VU	decreasing
Salamandra_atra	LC	decreasing
Salamandra_corsica	LC	stable
Salamandra_infraimmaculata	NT	decreasing
Salamandra_lanzai	VU	stable
Salamandra_salamandra	LC	decreasing
Salamandrina_perspicillata	LC	stable
Salamandrina_terdigitata	LC	stable
Taricha_granulosa	LC	stable
Taricha_rivularis	LC	stable
Taricha_torosa	LC	unknown
Triturus_carnifex	LC	decreasing
Triturus_cristatus	LC	decreasing
Triturus_dobrogicus	NT	decreasing
Triturus_karelinii	LC	decreasing
Triturus_marmoratus	LC	decreasing
Triturus_pygmaeus	NT	decreasing
Tylototriton_asperrimus	NT	decreasing
Tylototriton_kweichowensis	VU	decreasing
Tylototriton_shanjing	NT	decreasing
Tylototriton_verrucosus	LC	unknown
Tylototriton_wenxianensis	VU	decreasing